========================
=@                     =
======================#=
=  *  *   * *   ***  =#=
=  *   * *  *     *  = =
=  * ^ * *  *    *   =!=
=  ***  *   *** ***  =!=
====================== =
=!!= X  =XF=    =^ = =*=
=!!=    =!!=    =  =   =
====    ====    ====   =
=X             ^       =
=====================#==
=          ^        **X=
=KTMW               ***=
========================