========================
=X  !=              #*@=
====================#**=
= *  *   * *   *** =###=
= *   * *  *     * ===*=
= *   * *  *    *    =!=
= *    *   *     *   =!=
= ***  * ^ *** ***   =*=
====================== =
=F*   =======       ^  =
=**   # ^   #          =
=     ===*===          =
====#==== ====#=========
=   F =    =        ^  =
=KTMW = X  =           =
========================