========================
=X F=                 X=
=====      ^           =
=                      =
=*====================#=
=*= *  * ^ * *    *  = =
=*= *  *   * *   **  = =
=*= *   * *  *    *  = =
=*= ***  *   ***  *  = =
=*#=================== =
=#              ***=   =
================   =@  =
=X   #   =     =***=====
=    =   !             =
=KTMW= X =            !=
========================