========================
=   =   =    =    =    =
=   =   =    =    =    =
=   =   =    =    =    =
= . = * = o  = *  =  . =
=   =   =    =    =    =
=   =   =    =    =    =
=   =   =    =    =    =
=   =   =    =    =    =
=   #   #    #    #    =
=   #   #    #    #    =
========================