========================
=                      =
=                      =
=                      =
=         *            =
=    o         o       =
=                      =
=                      =
=                      =
=                      =
=                      =
========================